. 2 . . . . 3 . .
. . . 12 . . . . 3
5 . . . . 4 . . .
. . 6 . . . . 7 .
. . . . . . . . .
. 7 . . . . 3 . .
. . . 17 . . . . 9
5 . . . . 5 . . . 
. . 2 . . . . 9 .

B 2 N B N B 3 B N
B N B 12 B B N B 3
5 B N B N 4 B N B
B B 6 B B N B 7 N
N B B B B B N B B
B 7 N B B N 3 B N
B B B 17 B B B B 9
5 B N B B 5 N B N
B N 2 B N B B 9 B
